2222222222222222222222222222222
2000000000000001000000000000002
2011111101111101011111011111102
2000000001000101010001000000002
2111111101101101011011011111112
2000000000000000000000000000002
2111011101011101011101011101112
2000000001010101010101000000002
2111011101010101010101011101112
2000000001010101010101000000002
2011111101010101010101011111102
2000000101110101010111010000002
2111110100000000000000010111112
2000000101110220220111010000002
2011111101010233320101011111102
2000000001010233320101000000002
2111111101010233320101011111112
2000000001010222220101000000002
2011111101010000000101011111102
2010000001011110111101000000102
2010111101000010100001011110102
2010100001010010100101000010102
2010111101010110110101011110102
2000000101000100010001010000002
2011110101011101011101010111102
2000000100010000000100010000002
2010110101110110110111010110102
2010100101000100010001010010102
2110111101011111111101011110112
2000000000000000000000000000002
2222222222222222222222222222222
